11111111111111111111111
1C000000000000100000001
10000000000000000000001
11011100001111000000001
1E000000001111000000001
1111111100011100P000001
10000000000001000000001
10000000000001000000001
11011100001111000000001
10000000000000000000001
11111111111111111111111