11111111111111111111111111111111111111111
1EP00000000000000000000000000000000000001
1XXXXXXXXXXXXXXXXXXXXXXXXXXXXXXXXXXXXXX01
10000000000000000000000000000000000000X01
10XXXXXXXXXXXXXXXXXXXXXXXXXXXXXXXXXXX0X01
10X000000000000000000000000000000000X0X01
10X0XXXXXXXXXXXXXXXXXXXXXXXXXXXXXXX0X0X01
10X0X00000000000000000000000000000X0X0X01
10X0X0XXXXXXXXXXXXXXXXXXXXXXXXXXX0X0X0X01
10X0X0X0000000000000000000000000X0X0X0X01
10X0X0X0XXXXXXXXXXXXXXXXXXXXXXX0X0X0X0X01
10X0X0X0X000000000000000000000X0X0X0X0X01
10X0X0X0X0XXXXXXXXXXXXXXXXXXX0X0X0X0X0X01
10X0X0X0X0X00000000000000000X0X0X0X0X0X01
10X0X0X0X0X0XXXXXXXXXXXXXXX0X0X0X0X0X0X01
10X0X0X0X0X0X0000000000000X0X0X0X0X0X0X01
10X0X0X0X0X0X0XXXXXXXXXXX0X0X0X0X0X0X0X01
10X0X0X0X0X0X0XC0000000000X0X0X0X0X0X0X01
10X0X0X0X0X0X0XXXXXXXXXXXXX0X0X0X0X0X0X01
10X0X0X0X0X0X000000000000000X0X0X0X0X0X01
10X0X0X0X0X0XXXXXXXXXXXXXXXXX0X0X0X0X0X01
10X0X0X0X0X0000000000000000000X0X0X0X0X01
10X0X0X0X0XXXXXXXXXXXXXXXXXXXXX0X0X0X0X01
10X0X0X0X00000000000000000000000X0X0X0X01
10X0X0X0XXXXXXXXXXXXXXXXXXXXXXXXX0X0X0X01
10X0X0X000000000000000000000000000X0X0X01
10X0X0XXXXXXXXXXXXXXXXXXXXXXXXXXXXX0X0X01
10X0X0000000000000000000000000000000X0X01
10X0XXXXXXXXXXXXXXXXXXXXXXXXXXXXXXXXX0X01
10X00000000000000000000000000000000000X01
10XXXXXXXXXXXXXXXXXXXXXXXXXXXXXXXXXXXXX01
10000000000000000000000000000000000000001
11111111111111111111111111111111111111111